                   |                  |         |                         |
Alpha68k:           SNK Alpha 68000
Astrocade:          Bally Astrocade
Arkanoid:           Taito - Arkanoid
armedf:             Nichibutsu - Formation Armed F
Asteroids:          Atari - Asteroids
AsteroidsDeluxe:    Atari - Asteroids Deluxe
AtariTetris:        Atari - Tetris
atarisys1:          Atari System 1
Athena:             SNK - Athena
Bagman:             Valadon Aut. - Bagman
                   |                  |         |                         |
bakraid:            Raizing - Battle Bakraid
bankpanic:          SEGA Bank Panic
batrider:           Raizing - Armed Police Batrider
BattleZone:         Atari Battlezone
Berzerk:            Stern Elect. - Berzerk
BlackWidow:         Atari - Black Widow
blockade:           SEGA Blockade
BombJack:           Tehkan - Bomb Jack
bosconian:          Bosconian: Star Destroyer
Breakout:           breakout:EU
                   |                  |         |                         |
BurgerTime:         Data East - Burger Time
BurningRubber:      Data East - Bump 'n' Jump
CanyonBomber:       Atari - Canyon Bomber
Cave:               CAVE 68000
Centipede:          Atari - Centipede
Chameleon:          Jaleco - Chameleon
ComputerSpace:      Syzygy Engr. Computer Space
CongoBongo:         SEGA Congo Bongo
Cosmic:             Universal - Cosmic Alien
CosmicAvenger:      Universal - Cosmic Avenger
                   |                  |         |                         |
CosmicGuerilla:     Universal - Cosmic Guerilla
CrazyBalloon:       Taito - Crazy Balloon
CrazyClimber:       Nichibutsu - Crazy Climber
CrazyKong:          Falcon - Crazy Kong
CrystalCastles:     Atari - Crystal Castles
Defender:           Williams, Inc. Defender
demonwld:           Toaplan System 1 (Demon's World)
DigDug:             Namco - Dig Dug
Dominos:            Atari - Dominos
DonkeyKong:         Nintendo - Donkey Kong
                   |                  |         |                         |
DonkeyKong3:        Nintendo - Donkey Kong 3
DonkeyKongJunior:   Nintendo - Donkey Kong Jr.
Dorodon:            UPL Co. - Dorodon
DottoriKun:         SEGA - Dottori-kun
Druaga:             Namco - The Tower of Druaga
Exerion:            Jaleco - Exerion
expressraider:      Data East - Express Raider
Finalizer:          Konami - Finalizer: Super Transformation
FoodFight:          GCC - Charley Chuck's Food Fight
freeze:             Data Amusements - Freeze
                   |                  |         |                         |
Frenzy:             Stern Elect. - Frenzy
Galaga:             Namco - Galaga
Galaxian:           Namco - Galaxian
Galivan:            Nichibutsu - Cosmo Police Galivan
Gaplus:             Namco - Gaplus
Garegga:            Toaplan Version 2
Gauntlet:           Atari - Gauntlet
GnG:                Capcom - Ghosts 'n Goblins -old-
Gyruss:             Konami - Gyruss
IkariWarriors:      SNK - Ikari Warriors
                   |                  |         |                         |
Inferno:            Inferno:18_Coomon_EU
IremM62:            Irem M62
IremM72:            Irem M72
IremM92:            Irem M92
IronHorse:          Konami - Iron Horse
Jackal:             Konami - Jackal
Jailbreak:          jailbreak:EU
Joust2:             Williams Elect. - Joust 2: Survival of the Fittest
jt1942:             Capcom - 1942
jt1943:             Capcom - 1943: The Battle of Midway
                   |                  |         |                         |
jtaliens:           Konami Aliens
jtbiocom:           Capcom - Bionic Commando
jtbtiger:           Capcom - Black Tiger
jtbubl:             Taito - Bubble Bobble
jtcastle:           Konami - Haunted Castle
jtcommnd:           Capcom - Commando
jtcomsc:            Konami - Boot Camp
jtcontra:           Konami - Contra
jtcop:              Data East - RoboCop
jtcps1:             Capcom CP System
                   |                  |         |                         |
jtcps15:            Capcom CP System Dash
jtcps2:             Capcom CP System II
jtdd:               Technos - Double Dragon
jtdd2:              Technos - Double Dragon II: The Revenge
jtexed:             Capcom - Savage Bees
jtf1drm:            Capcom - F-1 Dream
jtflane:            Capcom - Fast Lane
jtgng:              Capcom - Ghosts 'n Goblins
jtgunsmk:           Capcom - Gun.Smoke
jthige:             Capcom - Pirate Ship Higemaru
                   |                  |         |                         |
jtkarnov:           Data East Karnov
jtkchamp:           Data East - Karate Champ
jtkicker:           Konami - Kicker
jtkiwi:             Taito - The NewZealand Story
jtkunio:            Technos - Renegade
jtlabrun:           Konami - Labyrinth Runner
jtmidres:           Data East - Midnight Resistance
jtmikie:            Konami - Mikie
jtmx5k:             Konami - Flak Attack
jtninja:            Data East - Bad Dudes Vs DragonNinja
                   |                  |         |                         |
jtoutrun:           SEGA Out Run
jtpang:             Mitchell Pang
jtpinpon:           Konami - Konami's Ping Pong
jttrack:            Konami - Track & Field
jtrastan:           Taito - Rastan
jtroc:              Konami - Roc'n Rope
jtroadf:            Konami Road Fighter
jtrumble:           Capcom - The Speed Rumbler
jts16:              SEGA System 16
jts16a2:            SEGA System 16A2
                   |                  |         |                         |
jts16b1:            SEGA System 16B1
jts16b2:            SEGA System 16B2
jts16b3:            SEGA System 16B3
jts16b:             SEGA System 16B
jtsarms:            Capcom - Hyper Dyne Side Arms
jtsbask1:           Konami - Super Basketball -version I-
jtsbaskt:           Konami - Super Basketball -version H-
jtshanon:           SEGA - Super Hang-On
jtsimson:           jtsomson:EU
jtslyspy:           Data East - Sly Spy
                   |                  |         |                         |
jtsf:               Capcom - Street Fighter
jtsectnz:           Capcom - Section Z
jttmnt:             Konami TMNT
jttora:             Capcom - Tiger Road
jttrojan:           Capcom - Trojan
jtvigil:            Irem - Vigilante
jtvulgus:           Capcom - Vulgus
jtyiear:            Konami - Yie Ar Kung-Fu
KickAndRun:         Taito Kick And Run
LadyBug:            Universal - Lady Bug
                   |                  |         |                         |
LunarLander:        Atari - Lunar Lander
MarioBros:          Nintendo - Mario Bros.
MCR1:               Bally Midway MCR-1
MCR2:               Bally Midway MCR-2
MCR3:               Bally Midway MCR-3
MCR3Mono:           Bally Midway MCR-3 Monoboard
MCR3Scroll:         Bally Midway MCR-3 Scroll
MegaSys1_A:         Jaleco Mega System 1-A
MissileCommand:     Atari - Missile Command
MoonPatrol:         Irem - Moon Patrol
                   |                  |         |                         |
MrDo:               Universal - Mr. Do!
MrJong:             Kiwako - BlockBuster
MysticMarathon:     Williams Elect. - Mystic Marathon
nemesis:            Konami - Nemesis
NextSpace:          SNK Alpha 68000
NinjaKun:           UPL - Ninja Kun
Pacman:             Namco - Pac-Man
Pengo:              Coreland - Pengo
PenguinKunWars:     UPL - Penguin-Kun Wars
Performan:          Toaplan - Performan
                   |                  |         |                         |
Phoenix:            Centuri - Phoenix
pipibibs:           Toaplan - Pipi & Bibis
Pleiads:            Centuri - Pleiades
PolyPlay:           VEB Polytechnik - Poly-Play
Pong:               Atari - Pong
Pooyan:             Stern Elect. - Pooyan
Popeye:             Nintendo - Popeye
prehisle:           SNK Prehistoric Isle in 1930
QBert:              Gottlieb - Q'Bert
rallybike:          Toaplan System 1 (Rally Bike)
                   |                  |         |                         |
RallyX:             Namco - Rally-X
RiverPatrol:        Orca - River Patrol
Robotron:           Vid Kidz - Robotron: 1984
RshnAtk:            Konami - Rush'n Attack
ScooterShooter:     Konami - Scooter Shooter
Scramble:           Konami - Scramble
SEGASYS1:           SEGA System 1
SilverLand:         Falcon - Silver Land
SlapFight:          Toaplan - Slap Fight
SMS:                SEGA System E
                   |                  |         |                         |
SnapJack:           Universal - Snap Jack
SNK68:              SNK 68000
SNK_TripleZ80:      SNK Triple Z80
snowbro2:           Toaplan - Snow Bros 2: With New Elves
SolomonsKey:        Tecmo - Solomon's Key
Sonson:             Capcom - SonSon
SpaceInvaders:      Taito - Space Invaders
SpaceRace:          Atari - Space Race
Sprint1:            Atari - Sprint 1
Sprint2:            Atari - Sprint 2
                   |                  |         |                         |
Subs:               Atari - Subs
SuperBreakout:      Atari - Super Breakout
TaitoSJ:            Taito System SJ
TankBattalion:      Namco - Tank Battalion
Tecmo:              Tecmo 1st Gen
terracresta:        Nichibutsu - Terra Cresta
TIAMC1:             Ekstrema-Ukraina TIA-MC-1
TimePilot:          Konami - Time Pilot
TimePilot84:        Konami - Time Pilot '84: Further Into Unknown World
TMNT:               Konami TMNT
                   |                  |         |                         |
TNKIII:             SNK - T.N.K. III
toaplan1:           Toaplan Version 1
TraverseUSA:        Irem - MotoRace USA
TropicalAngel:      Irem - Tropical Angel
truxton2:           Toaplan - Truxton II
TurkeyShoot:        Williams Elect. - Turkey Shoot
Ultratank:          Kee Games - Ultra Tank
VBall:              Technos - U.S. Championship V'Ball
vimana:             Toaplan System 1 (Vimana)
Xevious:            Namco - Xevious
                   |                  |         |                         |
XSleenaCore:        Technos - Solar Warrior
Zaxxon:             SEGA - Zaxxon
zerowing:           Toaplan System 1 (Zero Wing)
ZigZag:             LAX - Zig Zag
